NO textures/Wolfenstein/redbrick.xpm
SO textures/Wolfenstein/wood.xpm
WE textures/Wolfenstein/mossy.xpm
EA textures/Wolfenstein/greystone.xpm
F 20,20,20
C 200,200,200
1111111111111111111111111
10S0110000100000000000001
1000110000000000111111001
1000110000000000110001001
1000000000100000000001001
1111111111111111111111111
