NO textures/wolfenstein/mossy.xpm
SO textures/wolfenstein/eagle.xpm
WE textures/wolfenstein/red_brick.xpm
EA textures/wolfenstein/wood.xpm

F 18,53,25
C 153,204,255

111111111111111111111
100000000100000000001
100000000000000000011
111100000W00000000111
100000000000000001111
100000000000000000001
100000001010000000001
111111111111111111111
