WE textures/wolfenstein/grey_stone.xpm
NO textures/wolfenstein/purple_stone.xpm
SO textures/wolfenstein/red_brick.xpm
EA textures/wolfenstein/wood.xpm
F 20,20,20
C 200,200,200
11111111111111111111111111
10000000000111111000000001
10000000001      100000001
10000000000111111000000001
10000000000000000000000E01
1111111111111111111111111
