NO textures/wall/wall-01.xpm
SO textures/wall/wall-02.xpm
WE textures/wall/wall-03.xpm
EA textures/wall/wall-04.xpm

F 500,21,22

111111111111111111111
1W0000000000000000001
111111111111111111111
