WE textures/wolfenstein/grey_stone.xpm
NO textures/wolfenstein/purple_stone.xpm
SO textures/wolfenstein/red_brick.xpm
EA textures/wolfenstein/wood.xpm
F 20,20,20
C 200,200,200

11111111111111111111111
10000000000000000000001
10000011111111100000001
1000001       000W00001
10000011111111100000001
10000000000000000000001
11111111111111111111111
